1111111111111
10010000000C1
10000111110001
1P0011E000001
111111111111111