11111111111111111111111111111111111111111111111111111
100000000000000000000000000000000000000D0000000000001
100C0000001110000000C0000000011100000000001111000C011
1D000000001110000000000000000111000000000011110000011
11111111111110000000000000000111000000000011111111111
11111111111110000000000000000111000000D00011111111111
1100000000000000000000000D000111000000000000000000001
11000D000D1110000000000000000111000000000000000000001
110000C0001110000000000000000111000000000000011000001
11111111111110000000C0000000011100000C000000011000011
1111111111111000000000000000011100000000000001100C011
111111111111100D0000000000000111000000000000011111111
111111111111100000000000000001110000000D0000011111111
1P0000000000000000000000000000000000000000000000000E1
11111111111111111111111111111111111111111111111111111