1111111111111
10D10000000C1
1000011111D01
1P0011E000001
1111111111111